E E E E E E E E E E E E E E E E E E E E E E E E E E E E E E E E
E 0 A A A A A A A A A A A A A A A A A A A A A A A A 2 2 F A G G
E A A A A A A A 5 A A A A E E A A A A A A A A A A A A A A A A E
E E E A E A A E E E A E E E E E A A A A A A A E E A A A A A A E
E A A A A A W W A A A A A A E E E A A A A A A E E A A E A A A E
E A A A A A A A A A 1 A A A E E E E F F F F E E E A E A A A A E
E A E E E E A E A E E E A E E E E E E E E E E E E A E E E A A E
E F E E E E W E W W E W W W W E E A A A A A E E E A A A A A A E
E F E E E E W W W W W W E E W E E A A A 3 A A E E E A A A 4 A E
E F F E E E E E E E E E E E W W 5 W E A E A A E E E A A E E A E
E F F E E E E A A A E E E E W E W W E F E F F E A A A E E E W E
E F F E E E E A A A A A E E W E W W E F F F E E A A E E E W W E
E F E E E E 2 A A E E W W E W W W W E E F F E W W E E W W W W E
E F E E E E E E E E E E W W W W W W W W F F W W W W W W W W W E
E F F E E E E E F F E E E E E E W W W W F F W W W W W W E E E E
E F F F E E E F F F F F F G G G G F F F F F F F F F F E E E E E
E F F F F F F F F F F F F F F F F F F F F F F F F F E E E E E E
A A A A A A A A A A A A A A A A A A A A A A A F G A E E A G A E
E E E E E E E E E E E E E E E E E E E E E E E E E E E E E E E E